0111111111111
1001000000001
1000011111C01
1P0011E000C01
1111111111111