1111111111111
1X00110000X01
1000C11111001
1P0011E0000X1
1111111111111