1111111111111111111111111111111111
1E00X00000000S0C00000C000X0C000001
1010010100100000101001000000010101
101C0100101010100X1001000000010101
1P0000000C00C00000000000C0000000C1
1111111111111111111111111111111111