11111111111111111111
1P000000100000000011
11101110101111100011
10100010001000001011
10111001C10011111011
1000C000100000C000C1
10111110C00000101011
100000001010C0000011
10111100111011101011
10101000001000000011
1010101110C011111111
10100000101010000011
101C111000C010011011
10100000101000001001
10101010101110100011
10001000100000100011
1111111C111010111011
10000000000010000011
1011C1111111111100E1
11111111111111111111