11111111111111111111
1P100000100011111111
1010C000111011111101
10C000C0000011111011
101000C1C11111111111
10001010000000000011
11101010101101100011
10000010001000101001
10100011101010110011
10100000001010000001
10C11011101011111011
10100000001010001001
10001111101010100011
10001000100010101011
1110000111C110101011
10000000000000101001
1011101111101C101011
10001000000000100011
111111111111110110E1
11111111111111111111