11111111111111111111
1P100000100000100011
101011101000C1101011
10000010001000001011
1011C110C11111111001
100000100010000000C1
111C1011111000C01111
10001000001000100011
10101101101110011011
10100010100000100011
1010101010C010101111
10001010101010000011
10C01000101010001011
10101000100010001001
101010111110101C0011
10101000001010000001
10100111111010111011
10100000000000000011
1110111111110C1110E1
11111111111111111111