11111111111111111111
1P100000000010000011
10011011111010101C11
10001010000010100011
1110101011111010C011
10001010000000100011
10111001101111101111
1010000000C000100001
10C11111101000101011
10000010001000C01011
10011010101010001111
100000101000101000C1
1011C1101C0111110001
10100010100000000011
10100010101111111111
10001010000000100011
1011C0C1111010101011
111C0000000010000011
101010111110111C10E1
11111111111111111111