11111111111111111111
1P001000000000000001
11101011101111C11011
10101000000000001011
10101010111111101011
10101000C00000101011
10001110101C11001011
10100010C00000001011
10110010101011111011
10100010001010000011
10100111111011111C11
10001000000000000011
10111010111110111011
10001000001000100011
1110000010100111C011
10001010100010001001
10C11010110C1010C0C1
10000000100000C00001
1111111101111C1010E1
11111111111111111111