11111111111111111111
1P000000000000000011
11111101111110011011
10000000000010001011
10101001101010101011
10000000001010101011
1010C01C1011101010C1
101000100010001010C1
10111110010011C01011
10000000000010100011
10101010101100111111
10101000100000000011
101010101110101110C1
10000010100010001011
10111011100111100011
10001000001000001011
10100010111011111011
10001000000000000011
1111111C1110111110E1
11111111111111111111