11111111111111111111
1P100000001000000011
10101110001011101011
10100010000000100011
10C01000111010101111
10101010000010100011
10101010101100111011
10100010100010100001
10111010110110101011
100010100010001010C1
101010101010C0101011
10001000100010000011
111011101110101011C1
10001000100000100001
101C1011101110101011
10100010001000001011
10111010011011101011
10000010001000000011
1C1101C0110C101110E1
11111111111111111111