11111111111111111111
1P100000000000100011
10101110111C101010C1
10000010100010100011
10C01010110010111011
10001000100000000001
11111101101111111011
10000000000000000011
1010101101C111111111
10C01010001000000011
1010101010101CC11011
10101000001000000011
1010C010101010111011
10001010100010001011
1C101011100110101011
10100010000000101001
10101110111011001011
10000000000010000011
11111010C11011C110E1
11111111111111111111