11111111111111111111
1P000010000010000011
101110101010111C1011
10001000101000000011
111010101011C1111011
10000010C01000100011
101111101010C0101111
10001000100010101011
111010C0111C00101011
1000C010100000101011
10010010101011C01011
10100010101000001011
101110101010C1111011
10100010100000001011
101010111C1110101011
10001000000000C01011
1111001001100110C011
10000010000000100011
101001011C10101110E1
11111111111111111111