11111111111111111111
1P000000001000100011
111C1111101010101C11
10000000000010C00001
10011111111010101001
10001000001010001011
11101010100011111011
100010001000C0000011
10111010111110110011
10100010001000100011
101010111000001010C1
101010001010C0100011
1010C1C0100000111111
10001010001010000011
10011011111111111011
10001000001000000011
1C001011101011111001
100000100000100000C1
11101C111110110101E1
11111111111111111111