11111111111111111111
1P100000001000001111
100010C1101111101111
10000010C00000001011
11111110100010101111
10000010001000C00011
1001101011C011111011
10000000100000001011
1011011101111110C011
10001000000000101011
11C01011101110101011
10C00010000000001011
1011C001110011111011
10000010000000000011
101111101111111CC011
10C00010100010000011
101010C0111010110011
10001000000000100011
111C11111111110100E1
11111111111111111111