11111111111111111111
1P001000001000000011
11C0C011101011111001
10001010100000001011
10110010110111111011
10001000C00000001011
11101010101011101001
10101000100000100011
101010001011100110C1
10001010000010000011
10110010111110011001
10001000100000000011
10101111C01111101001
10001000100000100011
10101010111110101101
10100000100000C00011
101110C0101110011011
10000010000000000011
11C1111110C1C11100E1
11111111111111111111