11111111111111111111
1P100000000000000011
1010101C101010101111
10101000100010100011
10111110101011111011
10000000100010000011
111101C11C101010C011
10000000100000100001
10111101C01CC0111011
10100000001010001001
1010111C110010101101
10100000001000000011
10001111101111101011
10000000101000000001
10111111101011C01111
10000000001000100001
10101C10111110110011
10000010000000100001
111111111C11110101E1
11111111111111111111