11111111111111111111
1P0000001000100000C1
11110100101011101011
10001000001000101011
10111001C01C10110011
10001000001010100011
11101111111010101011
100010C0001010001001
10001010101011101001
10100010101000001011
10C11000101111101011
10100000100000001011
10101110101011101011
10100000000010000011
100C1110111110011C11
10000000000010000011
11101110111011101011
10001000000000000011
111111C1101011C100E1
11111111111111111111