11111111111111111111
1P100000100000100011
10101010101100C01011
10C01000001010101011
10101010101010100011
10000010000000101001
11011011C000101011C1
10000000001000100011
10101110111C001110C1
101010000000100010C1
10111011111011C01001
10001000001000001011
101011111011101010C1
10101000001000101011
11101001111011101011
100010001000100000C1
10101C1010111011C011
10100000C00000000011
111111111101111110E1
11111111111111111111