11111111111111111111
1P000000000000000001
1111C01011CC1110C011
1000C010000000101011
10101011110110101011
10101000C00000100011
1110111010110101C001
10001000101010000011
101010111010101110C1
10001000101000100011
10101010101110111111
10100010100010100011
101110C01110C0001001
101000C0001010001011
10C1C100101011111011
10001000100010000011
10100010111010101111
10100010000000000011
111111111110101100E1
11111111111111111111