11111111111111111111
1P000010000000100011
11111010101110001011
10100010001010100001
10100110111010001011
10101000100000101011
10101011101011111011
10001010001000000001
11101010101010C0C011
10100010001000100011
101011C11001C0101011
100000001000C0100011
11001011101010101001
10000000001000100011
10C11111101110111011
10100000C01000000011
10C11110101011011011
10000000100000000001
111101111111111111E1
11111111111111111111