11111111111111111111
1P000000100010000001
10110110101011111011
10001000001000100011
1100001111CC10101011
100010101000001010C1
10111010101111101111
10000000100010001111
11111010111010111101
10001000000010000011
101010111CC111100011
1010101010000000C011
10100010001111100011
10100000000010001011
1110001C10C010111111
10000000001010000011
101110C0101111111011
10000000000000000011
111111C10011101110E1
11111111111111111111