11111111111111111111
1P100000000000100011
10101111111100101001
1010000000000010C011
101110C111100000C0C1
10001010000010001011
11101110011111111011
10100010000010001001
1011101011C010011011
100010101000C0000011
10111011C00010111111
1010001000101000C011
1000111011101110C011
10000000100010001011
10111011001110011011
10001000100010000001
1100C110011000111111
100000001000C0000011
11100111111101C110E1
11111111111111111111