11111111111111111111
1P0000000000C0000011
10011101111011111011
10001000100000000011
10101010101110111001
10100010001000001011
101111110100111010C1
10000000100010100011
101010C1101110101001
1000101000C000101011
10101010011110101011
10001010100010C00011
10110010101000111C11
101000C0000010000011
10101000111010101011
10100010100000101011
10110110101010111011
10000000000010000011
1C111111C111111000E1
11111111111111111111