11111111111111111111
1P000000000000000001
10000000000000000001
10000000000000000001
10000000000000000001
1000000C0000CCCCC001
100000CC000C00000C01
10000C0C000000000C01
1000C00C00000000C001
100C000C0000000C0001
10CCCCCCC00000C00001
1000000C00000C000001
1000000C0000CCCCCC01
10000000000000000001
10000000000000000001
10000000000000000001
10000000000000000001
10000000000000000001
100000000000000000E1
11111111111111111111