1111111111111
1000100000001
1000001111001
1P0011E000C01
1000001111001
1000100000001
1111111111111