1111111111111
10X0100C00X01
1000001111001
1P0011E000001
1111111111111