11111111111111111111
1P000000001000001011
11111011101010101011
10000010001000100011
10001010101110101011
10001000101010101011
11100001101010101011
10000000100000101011
10101110111010101001
10000010100000101001
11100010101111100011
10000000100000100011
10101111111110111001
10100000000000000011
10100110111011111001
10100010000000100011
10011010001010101111
1000000000001000C011
100011010110111100E1
11111111111111111111