1111111111
1P00100011
1110111C11
1010001011
1011101011
1000101011
10111C1011
1C00000011
11111000E1
1111111111