1111111111111111111111111111111111111111111111111111111111111111111111111111111111111111111111111111
1P00100010000000000010001000000000000010100000100000000000100000001000000000001000100000000010001011
1010101011101011100110101001101110110010101011101101111110100110101111111011100000001101000010100001
1010000000100000101000100010000010000010001000000000001000101000100010001010000010000000000000000011
1000100100011010101011101011111011111010111100111001101011100011001010101010001111111111100111110001
1000000010001000100000100010000000000010001000001000001010001000001000001010101000000000000000100001
1001101011101010111101101000101010000011101011101001101010101111100110101100111011110111111000111011
1000100000100000001000001010001000001000001000100010000000100000100000100000100010000000000000001011
1100001010111010101001011010101111000010011110000010111111101010101110011111100110101111001111101011
1000101000001000001000001000100000001000001010000000001000000000001000100000001000000010001000101011
1011111010011100000101101110101011011110101010111110100000101000001011100110111010001011011010101011
1010000010100000000000000010001000000000100000100000000010100010001000001000000010000010001010101011
1011101010101111111011111011101010111111101010101010111110101010101101101010111111101100101010101001
1010000000100000100000001000100000000010000010101000000010101000101000000000100000000010100000001011
1010111000101100100110100110110110110010110110100101110010101110101110111110110101111010111111111111
1000101010101000100000000000100010001010000000001000001000001000100010000000000000001010001000000011
1111101000101010111110111111101010111011101011111110101010101010101001101111101011001001001011111001
1000001010001010000010000000001010000010000010000000001010000010001010000000100000101000100010000011
1011101001101010101001101010001010101110101010101011111010101110101010011110011101101110111110100011
1000001010001000100000001010101000000000001000101000001000100000100000000000000000001000000010101011
1010101011101011001111000010101101111101101010100111101101110010001101011010011111101011111110001011
1010100000101000100000001010001000001000001010000000100000001000100000000000000000001010000000100011
1010101010111110111011111011000011001110101011101000001100101111110110001111001100111010101111101111
1010101010000010000000101010001010100000101010001000001000000000000000001000000000001010100000000011
1010100011100011011110001011100010111110011000111010110011001010011011110010111011101010101110111001
1010001010001000001000000000000010000000000010001010000000001000101000000010100010000010000010000001
1011111010110111101011101011111110101111111110101010011100101010100011101110101110111110011011101011
1000100000000000000010000000100000100000000010100010000000001010100000100000100000100000000010100011
1010101111110011111110101110111100101011111001111110101111101000011110101010101010101101101100111011
1000001010000000001000000010000010001010000000000000100010001010000000101000000000001000000010000011
1010111010101011111001011011110011010001011111101111011000111011111100111110111010101110001010101001
1000001010001000001010100000101010001000100000100010000010001010000010000000100010000000101000001011
1011001001001101101010100110101010100100100100101000101010111010111011100110101011001000100111111011
1000101010001000101010000010001010100000100010001000101000100010001000000000000000001010101000001011
1011101010110010101010111111011010110101101011100110100001101100101011101001111001011000101110001001
1010001010101010001010000000001010000000100000100000101000001000100000001000000000100000100000000001
1010011010101000101010010101101010101100111110101110001111101111100101111110111110101110111010110011
1010100000000000000010000000101010100010000000101000100000100000000000000010001000101000001010000011
1010111111111110111010111110101011111010111011001011110100111111111111001010111010101011101010100011
1010001000001000100010000000101000000010000010001010000010001000000010000000100010100000100010101011
1010101110101011000000111110101110001011101000111010111011101010111010110110101101110110101110101001
1000001000100000000010100010101000000000001000001000001000100000000010001000101000001010000010001011
1111101001101111100110101010100010111010101111101011100111101011100111101011101010101001001011101011
1000101010000010000000100000100010000000100000001000100000001010000000100000100010100010001010001011
1010101010110000110001001010110111101111001110111100011110101010101110011110010000111010001010101111
1010001000001000001000001000000000100010000000000010000000100000000010000010001010000000101000100011
1010101111111101101001111011101001011011111011011010111011001110110011111111101010111111100110011011
1010100010001000100010000010001000001000100000001000101000000010001000000010101000000000001000100011
1011110000101010111110111110111000101010100101100110100010111000101110111010101001011111101110101011
1000001000101000001000100010000000000000000000101010101000100010101000100000001000100010000000101011
1010101111101010001011101010000110101011110010101010101011101010101010101110101010100000001011101111
1000100010000000100010001000000010100000001000101010101010001000100010100000001010100000101000000011
1010101000010111110011111011101010011111101001101010101011110011101010110011101011101000101010111011
1010101010100000000000000010000010000000101010101000101010000010001010101000000000001010001010001011
1010101110111011011010111111011000011110101010101110101000111010111000100111101011110011101010101011
1000100000100000000010000000101010000000001000100010001010000010000010000000000000000000001010000011
1010000011101111111010111010101010111110110010111000011000101001111101010111110111101101111010101011
1000100000100000100010101000100010001000000000101010100000001000100000000000000000100010001010101011
1001100010001110101110001011110111000010101111101000001111111010101111110101000001011010101010001011
1000100010000000101000001000000000001000000000001000001000100010100000000000100000001000100010001011
1010101010000111101011101011110111111010110111101010011010001110000111101111111010100111101110010111
1010001010000000101000100010000000000010000000001000001000001000100000001000001000101000101010100011
1011111010111100100010010100111111101111111011100111101011101010110111101011001001111000101000101011
1010000010100010101010001000001000100000000000001000100000101010101000101000101000000010000010001011
1011111010101000100111101011111010000010011101000011101011100010101000101010100110011111101111111001
1010001000001010100000100000100000101000000010100010000000001000000010100010001000100000000010000011
1000101011101011011000100100001100110001101000101010111111111010100000001010101010001101111010011011
1000000000000000000010101000001000000010001010001000100010100000100000100010000010100010000000101011
1010101111001011111010001011101110111010101011001010101010101011011110001010101010111011101110101011
1010101000000000001000000010000000100000100000000010101000101000000000101010100010001000100000100011
1010101110111001100010001110101111101011101010111100001010001011101010101010000110101110111111100111
1000000010000000001010001010100000100010101010000000101000101010101000001000001000100010100000100011
1011001010101110101001111000111110001010101010001100101110101010101111001110111010100110101110110011
1000001000001000100010000010001010000010100000000000000010100010100000100000000010000000101000001011
1111111110101011111111011011101011101010100110111011100010101010110011101111101110111011101011101001
1000000000100010000000000010100010000010100000001010001000101010000000001000100010001011101000001011
1011100011111010101110111010101010001110111010010010111010101010101111101010010001001011101111101011
1000100000000010100000100000000000101000001000100010001010101010000010000010000000000011100010101011
1010111110111100101010111010111111101011001100001111101001101000011011110011110010101111111000101001
1010000000001010101010001010001000100000000010100000000000100010001000001000001000100000100010001011
1101111101100000111011101101101010101110100100111111111110100011101010101101101001001110101110111001
1000000000001010001000100000001010000000100000000000000000100000001000000000001010000000000000000011
1011111101100011100010111110111110011010100011111111100000100111011011010110101010011000101111110101
1010000000101000100000000010000010100010000000000000000010000000000000001010100010001010100010001011
1011101010101010101110011011001010001100111111101111101000011101110101101010100010101001111010101011
1000100010101010000000001000100000000000000000000000101010001000100010001000100000100010000010100011
1110100011100001101111101110101111011010110011111111101010101010101010010110101101101010111010111011
1000101000001000000000000010000000000000100010001000101000000010001010100000100000101000100000100001
1011101101111001111111111000001011101110101110101000111110111010001000100011101110001011111011101111
1000100000000010000010000000100000101010100000000010000000100010101000100000000010100010001010001011
1110101010111111001000101111111110101000101011111111011111111010101011111001111010101010100000110011
1000000010100000001010100010000000100000100010000000000000100010001000001000101000100000100010000011
1011011110000110011000000001111010101010111110111111111110100110101011001110101110111011111011011001
1000000000100010001010100000100010000010000000000000000000100010100010000000100010100000001010000011
1011111111111011101010001110101110101111110001101010011111101010101100110111011010000100101010111101
1000000010000010000010101000101010000000101000000010000000000010001010100000001010000000001010001011
1011001011101110111101100010101000101110101111111111101110000010100010111011001011101001111011001011
1000001000001000000000001000001000000000001000000000000000100000000010000010001000001000000010000011
1111010000101101110010111101110110101111000000000111110111101110111110110111111101111011111110C000E1
1111111111111111111111111111111111111111111111111111111111111111111111111111111111111111111111111111