11111111111111111111111111111111111111111111111111
1P000000000000100000000000100000001010000000100011
10001010101010101010001111100010101010011100100001
10001000001010001000100000101000000010100000101011
10111110110110111010011110101001111010000001011001
10100000000000001010100010101000001000101010100011
10110110111010101010101000101111101101001010101011
10000000100010000010001000100000101000000010000011
10001110110110110101011111111000101010111101100011
10000010001000000000000000000010001010101000001011
10111010101011001111101111101010111010001010111011
10100000001000000000100000100010101000101010000011
10101111110011100110100110111100001011101010101111
10100000000000000000100010101000101010001010100011
10011011011011010010111010101010101010101010011011
10001000100010000000000010001010000010100000100011
10010000101001111010111110101010010011011010111011
10000010000000001000000000101010000010000000100011
10101100100111100010110110100001101100001111101001
10101000101000101000100010101010101000100000100011
10101011101001101110101110101010101011101110000011
10100010000000001011101000101000000010100000101011
10111110101110111111101011111010111110011010001001
10100010001000100000000000000010100000100010100011
10111000111010111111100011101110001100101111101011
10001000100000000010001000101000001000000000000011
11101110101011101010111110101101111010111010111101
10001000001000000000000000001000100010000010100011
10111000111001101001111011111010001010100110101111
10000000101000101000000010000010001000000000100001
11001110101110101010111110111011011001111110111011
10100010000000001000000010001000001000100010000011
10011010111100111100111010101110101110001010100011
10001000000000001000000000100010000010001000100001
10111011110010101011100101111010101101101111111011
10000000100010101000000000000010000000000000000011
11111010101010110110110110101010101101111001111011
10000010101010000000100010001000100000001000101011
10101010101110111111101000111110001110001010101011
10000010001000100000000010000010001000100000000011
10111111111011101110101100101110101011111010010011
10000010001010000000000010100000001000001010100011
10000000101001111110101010101010111111101110101111
10001010101000100000000010100010100000100000100011
11010010110110101011101110110000001110011011111011
10001010100010001010000010000010101000000000000011
10101010001000001010001011011110101010111010001111
10000010001000000010000000000010000000000010C00001
101100001100100000111000011110110100100101101111E1
11111111111111111111111111111111111111111111111111