11111111
1CCCCC01
1PCCCCC1
1CCCCCC1
1CCCCCC1
1CCC11E1
11111111