1111111111111
1000100000001
100C001111001
1P0011E0C0011
1111111111111