1111111111111
1000100C00001
1000101111001
1P0011E000001
1111111111111